
NO ./resources/Dogecoin.xpm
SO ./resources/Dogecoin.xpm
WE ./resources/Dogecoin.xpm
EA ./resources/Dogecoin.xpm

F 0,100,200
C 50,50,50

        1111111111111111111111111
        1000000000110000000000001
        1011000001110000000001111
        1000000000000000000001111
111111111101100000111000000000001
100000000000011100111011111111111
11110111111111011100000010001
111101111111110111010100000W1
1100000011 111011100000010001
100000000011100001000000010001
10000000000000001101010010001
1100000111010101111101111000111
11110111 1110101 10111010001
11111111 1111111 111111111111
111
101
111