NO ./resources/wall1.xpm
SO ./resources/wall2.xpm
WE ./resources/wall3.xpm
EA ./resources/wall4.xpm

DOOR ./resources/door.xpm

F 0,100,200
C 50,50,50

        1111111111111111111111111
        100D000000110000001000001
        101100000111000000D001111
        1000000000000000001001111
111111111101100000111000000000001
100000000000011100111011111111111
1111011111111101110000001D101
111101111111110111010100DWD1
1100000011 11101110000001D101
100000000011100001000000010001
10000000000000001101010010001
1100000111010101111101111000111
11110111 1110101 10111010001
11111111 1111111 111111111111
111
101
111

