
NO ./path_to_the_north_texture
SO ./path_to_the_south_texture
WE ./path_to_the_west_texture
EA ./path_to_the_east_texture

F 0,100,200
C 50,50,50

        1111111111111111111111111
        1000000000110000000000001
        1011000001110000000000001
        1001000000000000000000001
1111111111011000001110000000000001
10000011000001110111111111111111
11110111111111011100000010001
111101111111110111010100100N1
1100000011 111011100000010001
100000000011100001100000010001
10000000000010001101010010001
1100000111010101111101111000111
11110111 1110101 10111010001
11111111 1111111 111111111111
111
101
111