1111111111111111111
11000000000C00E0101
10CCC00000000000011
10P0011100001111111
100000C000011000011
1111111111111111111