NO ./resources/wall1.xpm
SO ./resources/wall2.xpm
WE ./resources/wall3.xpm
EA ./resources/wall4.xpm

F 0,100,200
C 50,50,50

11111
11011
 0N01
11011
11111