NO ./resources/wall1.xpm
SO ./resources/wall2.xpm
WE ./resources/wall3.xpm
EA ./resources/wall4.xpm
F 0,100,200
C 50,50,50


11111111111111111111111
100000000000000000000W1
11111111111111111111111