NO ./resources/wall1.xpm
SO ./resources/wall2.xpm
WE ./resources/wall3.xpm
EA ./resources/wall4.xpm
F 0,100,200
C 50,50,50


     111111111111111
     100001000000001
     100001000111101
     101001001100001
     100001111000001         11111111
     100000000000001      1111000000111
     100000100001111    1110010000110011111
     101000110000001   110000001001000010011111111111
     100000011000001   1001000000000000000000000000011111111111
     111111111000001   1000010000100000011110000000000000000001
             1000001  11010000000000000011111111111100001000001
  1111       1000001111001110011111111111   1110000100001111001
  1001       10E000000100101100010000011      11100111111000001
  1111       10000000000000101000010011         110000000001001
         11111000000111001111111110011           11111111111111
        1100010000011 1000000100000011
       1100001000001  110000010000011     11111
      11000010000001   1100001000011      11011111
     110000100001001    11000000011       11000001
     100001000010001     110000011        11011111
     11000010010000111    1111111         11111111
      11100011000011
        11100000011
          11111111